List of automobile manufacturers of Germany	0
Contents	0
Navigation menu	0
Personal tools	0
Namespaces	0
Views	0
More	0
Navigation	0
Interaction	0
Tools	0
Print/export	0
Languages	0
German Car Brands Names – List And Logos Of German Cars	0
A Little German Cars History	0
Company Names, and List & Logos of All German Car Brands	0
Car Brands List	0
Most Popular German Car Companies	0
Other Active German Auto Manufacturers	0
Non-Active German Car Makes List	0
Related Posts	0
Like Us On Facebook	0
Car Reviews	0
Featured Posts	0
Maintenance Tips	0
Browse Categories	0
Website Under DMCA Protection	0
Audi – “Truth in Engineering”	0
Mercedes Benz	B-ORG
Mercedes-Benz’s luxury cars: Limousines	0
BMW	B-ORG
Volkswagen	B-ORG
Porsche	B-ORG
Adam Opel AG	B-ORG
Alpina	B-ORG
Bitter Cars	B-ORG
Gumpert	B-ORG
Isdera	B-ORG
Keinath	B-ORG
Adler	B-ORG
Auto Union AG	B-ORG
DKW	B-ORG
Borgward	B-ORG
BMW’s luxury cars	0
German Car Brands	0
The Cartel: Collusion Between Germany's Biggest Carmakers	0
Automotive Industry	0
Serviceangebote von SPIEGEL-ONLINE-Partnern	0
SPIEGEL GRUPPE	0
DER SPIEGEL	0
Dein SPIEGEL	0
Edition Geschichte	0
LITERATUR SPIEGEL	0
UNI SPIEGEL	0
SPIEGEL GESCHICHTE	0
SPIEGEL WISSEN	0
SPIEGEL BIOGRAFIE	0
SPIEGEL CHRONIK	0
Edition Wissen	0
AUTO	0
ENERGIE	0
JOB	0
FINANZEN	0
FREIZEIT	0
List of the Best German Cars	0
Mercedes-Benz	B-ORG
Porsche	B-ORG
Volkswagen	B-ORG
Audi	B-ORG
BMW	B-ORG
German Car Logos	0
British Car Logos	0
List of the Best Drifting Cars	0
Recent Posts	0
Find us on Facebook	0
Categories	0
Twitter @carbrandslist	0
Related Articles	0
